{
    "world_stat_history_list": [
        {
            "world_id": "18",
            "stat_name": "EmpireScore.NoTabScreen.VS",
            "type": "EmpireScore",
            "tracker_name": "NoTabScreen",
            "faction": "vs",
            "all_time": "0",
            "day": {
                "d01": "0",
                "d02": "0",
                "d03": "0",
                "d04": "0",
                "d05": "0",
                "d06": "0",
                "d07": "0",
                "d08": "0",
                "d09": "0",
                "d10": "0",
                "d11": "0",
                "d12": "0",
                "d13": "0",
                "d14": "0",
                "d15": "0",
                "d16": "0",
                "d17": "0",
                "d18": "0",
                "d19": "0",
                "d20": "0",
                "d21": "0",
                "d22": "0",
                "d23": "0",
                "d24": "0",
                "d25": "0",
                "d26": "0",
                "d27": "0",
                "d28": "0",
                "d29": "0",
                "d30": "0",
                "d31": "0"
            },
            "month": {
                "m01": "0",
                "m02": "0",
                "m03": "0",
                "m04": "0",
                "m05": "0",
                "m06": "0",
                "m07": "0",
                "m08": "0",
                "m09": "0",
                "m10": "0",
                "m11": "0",
                "m12": "0"
            },
            "week": {
                "w01": "0",
                "w02": "0",
                "w03": "0",
                "w04": "0",
                "w05": "0",
                "w06": "0",
                "w07": "0",
                "w08": "0",
                "w09": "0",
                "w10": "0",
                "w11": "0",
                "w12": "0",
                "w13": "0"
            },
            "last_save": "1393575104",
            "last_save_date": "2014-02-28 08:11:44.0"
        }
    ],
    "returned": 1
}